 Good going, champ
Bum=vago/a
Here we go=aquí vamos
Moth=polilla
Shell shock
Borrow= pedir prestado
Thumb=pulgar
skid=patinaje
Stuff=cosas
creep=arrastrarse
i pass by= paso por
Stinker=huele
Garbage=basura
Whore=puta
Hang down=colgar
Screw you=púdrete
beacon=FARO
Transmitions are being JAMMED=Transmisiones han sido atascadas
without a doubt=Sin duda
hang on= agarrate
Unaware i was= inconsiente estuve yo (YODA)
fair=justo
split up=separense
left behind= dejado atrás
beside= junto a/a lado de
outhing=superar
perhaps=quizás
polite=cortés, educado
finally, at last= porfín, finalmente
indeed=en efecto
whom=quien
shatter=frustrarse
whistling birds =pajaros silbantes
lodging=alojamiento, hospedaje, aposento
fee=tarifa
whole=todo, He ate a whole pie
harvest=cosecha
deterrent=disuadorio
barn=granero
blankets=mantas
thougtful=pensativo
although=aunque
matters=impornatnte
get away=aléjate
grudge=rencor
sort=ordenar
sorts=tipo de
catchphrase=eslogan
fits right in = encaja perfectamente en
path=sendero,camino
pity=pena
injured=herida/o
whines=lloriqueos
tale=cuento
story= historia, cuento
guild=gremio
fob=engañar
attempt=intento
warm=tibio
scoring=almacenado			
mess=desorden
gorgeous=preciosa